Steve Jobs
Unbroken: A World War II Story of Survival, Resilience and Redemption
Einstein: His Life and Universe
Into the Wild
John Adams
Team of Rivals: The Political Genius of Abraham Lincoln
Marie Antoinette: The Journey
Catherine the Great: Portrait of a Woman
The Immortal Life of Henrietta Lacks
Truman
Martin Heidegger: Between Good and Evil
Oscar Wilde
Alexander Hamilton
Wild Swans: Three Daughters of China
Cleopatra: A Life
Mary Edwards Walker: America's Only Female Medal of Honor Recipient
The Rise of Theodore Roosevelt
Bonhoeffer: Pastor, Martyr, Prophet, Spy
Elon Musk: Tesla, SpaceX, and the Quest for a Fantastic Future
The River of Doubt: Theodore Roosevelt's Darkest Journey
No Ordinary Time: Franklin and Eleanor Roosevelt: The Home Front in World War II
Destiny of the Republic: A Tale of Madness, Medicine and the Murder of a President
In the Garden of Beasts: Love, Terror, and an American Family in Hitler's Berlin
Nicholas And Alexandra
Benjamin Franklin: An American Life
The Power Broker: Robert Moses and the Fall of New York
Thomas Jefferson: The Art of Power
Tesla: Inventor of the Modern
The Six Wives of Henry VIII
Peter the Great: His Life and World
The Wives of Henry VIII
Titan: The Life of John D. Rockefeller, Sr.
Undaunted Courage: The Pioneering First Mission to Explore America's Wild Frontier
Theodore Rex
The Professor and the Madman: A Tale of Murder, Insanity and the Making of the Oxford English Dictionary
The Last Lion: Winston Spencer Churchill: Visions of Glory 1874-1932
Encounters and Dialogues with Martin Heidegger, 1929-1976
Frida: A Biography of Frida Kahlo
Mountains Beyond Mountains: The Quest of Dr. Paul Farmer, a Man Who Would Cure the World
The Path to Power
Elizabeth the Queen: The Life of a Modern Monarch
Longitude: The True Story of a Lone Genius Who Solved the Greatest Scientific Problem of His Time
The Snowball: Warren Buffett and the Business of Life
Washington: A Life
Helen Keller: A Life
Mornings on Horseback: The Story of an Extraordinary Family, a Vanished Way of Life, and the Unique Child Who Became Theodore Roosevelt
Virginia Woolf: A Biography
The Life of Elizabeth I
Churchill: A Life
The Confessions of St. Augustine
The Passage of Power (The Years of Lyndon Johnson, #4)
The Last Lion: Winston Spencer Churchill: Alone, 1932-40
Master of the Senate
Tolstoy
Adolf Hitler
No One Here Gets Out Alive
The Mitford Girls: The Biography of an Extraordinary Family
Means of Ascent (The Years of Lyndon Johnson, #2)
Eleanor of Aquitaine: A Life
Genghis Khan and the Making of the Modern World
The Black Count: Glory, Revolution, Betrayal, and the Real Count of Monte Cristo
Lincoln
A Writer's Diary
American Lion: Andrew Jackson in the White House
Abraham Lincoln: The Prairie Years and the War Years
Seabiscuit: An American Legend
The Children of Henry VIII
The King's Speech: How One Man Saved the British Monarchy
Walt Disney: The Triumph of the American Imagination
Henry VIII: The King and His Court
Last Train to Memphis: The Rise of Elvis Presley
Will in the World: How Shakespeare Became Shakespeare
The Man Who Knew Infinity: A Life of the Genius Ramanujan
His Excellency: George Washington
Love and Louis XIV: The Women in the Life of the Sun King
Parting the Waters
Rajinikanth: The Definitive Biography
Blockade: The Diary of an Austrian Middle-Class Woman, 1914-1924
The Mayor of Castro Street: The Life and Times of Harvey Milk
To the Rescue: The Biography of Thomas S. Monson
Go Forward with Faith: The Biography of Gordon B. Hinckley
The Color of Water: A Black Man's Tribute to His White Mother
Zelda
King Leopold's Ghost
The Wright Brothers
Becoming Queen Victoria: The Tragic Death of Princess Charlotte and the Unexpected Rise of Britain's Greatest Monarch
Malcolm X: A Life of Reinvention
Secrets of the Flesh: A Life of Colette
Room Full of Mirrors: A Biography of Jimi Hendrix
The Twelve Caesars
The Real James Herriot: A Memoir of My Father
A Beautiful Mind
Hitler: A Study in Tyranny
When Character Was King: A Story of Ronald Reagan
iCon: Steve Jobs, the Greatest Second Act in the History of Business
American Caesar: Douglas MacArthur 1880-1964
Ronald Reagan: How an Ordinary Man Became an Extraordinary Leader
Frida Kahlo: 1907-1954 Pain and Passion
Steve Jobs: The Unauthorized Autobiography
The Strangest Man: The Hidden Life of Paul Dirac, Mystic of the Atom