John Adams
The Rise and Fall of the Third Reich: A History of Nazi Germany
1776
Team of Rivals: The Political Genius of Abraham Lincoln
The Guns of August
Guns, Germs, and Steel: The Fates of Human Societies
The Diary of a Young Girl
Hiroshima
Unbroken: A World War II Story of Survival, Resilience and Redemption
Bury My Heart at Wounded Knee: An Indian History of the American West
A Distant Mirror: The Calamitous 14th Century
The Devil in the White City
A People's History of the United States
Battle Cry of Freedom
A Short History of Nearly Everything
The German Genius: Europe's Third Renaissance, the Second Scientific Revolution, and the Twentieth Century
The Histories
The Blood Never Dried: A People's History of the British Empire
Undaunted Courage: The Pioneering First Mission to Explore America's Wild Frontier
The Decline and Fall of the Roman Empire
The Stripping of the Altars: Traditional Religion in England, 1400-1580
Night (The Night Trilogy, #1)
Truman
All the Countries We've Ever Invaded: And the Few We Never Got Round To
History of the Peloponnesian War
1491: New Revelations of the Americas Before Columbus
Stalingrad: The Fateful Siege, 1942–1943
A Peace to End All Peace: The Fall of the Ottoman Empire and The Creation of the Modern Middle East
The Rape of Nanking
Churchill's Secret War: The British Empire and the Ravaging of India During World War II
The Rise of Theodore Roosevelt
1939 - The War That Had Many Fathers: The Long Run-Up to the Second World War
Band of Brothers: E Company, 506th Regiment, 101st Airborne from Normandy to Hitler's Eagle's Nest
The Civil War: A Narrative
Mary Edwards Walker: America's Only Female Medal of Honor Recipient
Als die Soldaten kamen: Die Vergewaltigung deutscher Frauen am Ende des Zweiten Weltkriegs
Germania
Paris 1919: Six Months that Changed the World
The Sleepwalkers: How Europe Went to War in 1914
Peter the Great: His Life and World
The Worst Hard Time: The Untold Story of Those Who Survived the Great American Dust Bowl
Genghis Khan and the Making of the Modern World
The Real Lincoln: A New Look at Abraham Lincoln, His Agenda, and an Unnecessary War
Endurance: Shackleton's Incredible Voyage
Mayflower: A Story of Courage, Community, and War
The Twelve Caesars
Marie Antoinette: The Journey
Catherine the Great: Portrait of a Woman
The Proud Tower: A Portrait of the World Before the War, 1890-1914
King Leopold's Ghost
Nicholas and Alexandra
Lies My Teacher Told Me: Everything Your American History Textbook Got Wrong
Theodore Rex
The Gulag Archipelago 1918–1956
Legacy of Ashes: The History of the CIA
Ghost Soldiers: The Epic Account of World War II's Greatest Rescue Mission
The Pity of War: Explaining World War I
In the Heart of the Sea: The Tragedy of the Whaleship Essex
Empire of the Summer Moon: Quanah Parker and the Rise and Fall of the Comanches, the Most Powerful Indian Tribe in American History
Seven Years in Tibet
Manhunt: The 12-Day Chase for Lincoln's Killer
The Professor and the Madman: A Tale of Murder, Insanity and the Making of the Oxford English Dictionary
The Very Bloody History of Britain
How the Irish Saved Civilization: The Untold Story of Ireland's Heroic Role from the Fall of Rome to the Rise of Medieval Europe 
Alexander Hamilton
Citizen Soldiers: The US Army from the Normandy Beaches to the Bulge to the Surrender of Germany
With the Old Breed: At Peleliu and Okinawa
Collapse: How Societies Choose to Fail or Succeed
Rubicon: The Last Years of the Roman Republic
The Trigger: Hunting the Assassin Who Brought the World to War
Longitude: The True Story of a Lone Genius Who Solved the Greatest Scientific Problem of His Time
The Making of the Atomic Bomb
The Fall of Berlin 1945
Tesla: Inventor of the Modern
Salt: A World History
The Annals of Imperial Rome
Destiny of the Republic: A Tale of Madness, Medicine and the Murder of a President
The Federalist Papers
Blood in Zion: How the Jewish Guerrillas Drove the British Out of Palestine
Einstein: His Life and Universe
No Ordinary Time: Franklin and Eleanor Roosevelt: The Home Front in World War II
The Longest Day
His Excellency: George Washington
The Coming of the Third Reich (The History of the Third Reich, #1)
Hitler: 1889-1936 Hubris (Hitler, #1)
Bloodlands: Europe Between Hitler and Stalin
Founding Brothers: The Revolutionary Generation
Cleopatra: A Life
A History of Britain: The Wars of the British 1603-1776 (A History of Britain, #2)
A People's Tragedy: The Russian Revolution: 1891-1924
Europe: A History
The Last Lion: Winston Spencer Churchill: Visions of Glory 1874-1932
Cicero: The Life and Times of Rome's Greatest Politician
The Path Between the Seas: The Creation of the Panama Canal, 1870-1914
The March of Folly: From Troy to Vietnam
The Assassination of the Archduke: Sarajevo 1914 and the Romance that Changed the World
The Prize: The Epic Quest for Oil, Money, and Power
Ashes And Blood: The British Army In South Africa, 1795 1914
We Were Soldiers Once... and Young: Ia Drang - The Battle that Changed the War in Vietnam